方같같같같같같같같같
겡같같같같같같같같같
같方같같같같같같같같
같겡같같같같같같같같
같같方같같같같같같같
같같겡같같같같같같같
같같같方같같같같같같
같같같겡같같같같같같
같같같같方같같같같같
같같같같겡같같같같같
같같같같같方같같같같
같같같같같겡같같같같
같같같같같같方같같같
같같같같같같겡같같같
같같같같같같같方같같
같같같같같같같겡같같
같같같같같같같같方같
같같같같같같같같겡같
같같같같같같같같같方
같같같같같같같같같겡
