░███░░░█░██░░░██░░░█░░░█░░░░░░░░█░░░░░░█░░░░░█░█████░░█░░░░██░░░░█░░░░█░░░░████░░░░█░█░░░░░░░███░░░█░░░░█░░░██░░█░░░░███░░░█░░░░█░░█░░░██░░░█░░░░█░░░░█░░░░░░█░░░█░░██░░█░░░█░░░░█░░░░░██░░░██░░█░░░█░░░░░█░█░░█░░░░░░░█░█░░░░░█░░░███░░█░░
░░░░░█░██░░░█░█░░█░░░█░█░░░░░░░██░████░░░███░██░░░░░░█░░██░░░░██░█░░░░█░██░█░░░░██░███░░████░░░░░█░█████░░█░░█░██░███░░░█░█░░██░░░██░█░░░░█░█░█░░█░███░░████░█░██░░░░░███░█░░░██░░░███░░░░█░░░█░░░█░█░██░░█░░█░█░█████░░█░░███░░███░░░█░░█░
░░█░█░░██░██░░█░██░███░█░░░░░░█░░░█░████░█░░░░█░█░░█░░██░█░█░███░░████░░█░░░░███░█░░░░█░█░░░██████░█░░░░░█░█░█░░░░██░░█░█░█░█░█░██░░░███░█░░███░██░░░░░█░░░░░█░░█░███░░░░░███░█████░░░█░███░█░░█░█░█░░██░█░█░░░░░░░░░███░░█░░░█░░░░░█░██░░░
███░█░░██░░█░██░░█░░██░░█░██░█░░█░█░░░█░░█░██░█░█░█░█░░░██░░█░░░█░█░░░░██░█░██░░░░██░██░░░█░░░█░░█░█░███░█░░░████░██░█░░██░░█░█░░█░█░░░█░█░█░░░░░░█░█░█░░██████░█░█░░█░█░█░░██░░░█░░░█░░█░█░██░░░░█░░█░░░█░░█████░██░░██░██░█░░███░██░░██░█
░░█░░█░░█░░█░█░█░░░░███░░█░░█░░█░░███░░░██░░░██░░█░░░██░█░█░░░█░██░░█░█░█░█░█░░██░░█░░█░██░░█░████░░░█░█░░███░░░█░░█░█░█░░░█░░██░█░░██░█░█░░░░░██░░██░░██░░░░░█░░░█░██░░░█░█░░░█░█░░█░░█░░█░░████░░██░░█░░███░░██░█░█░█░░░░░██░░░█░█░░█░░░░
░█░█░░█░█░██░░██░███░░░█░░░░█░████░░░██░░█░█░██░░█░░█░░░█░█████░░█░█░░██░░█░█░█░░█░░█░░░█░░█░░░░░█░░█░█░░█░░░░█░██░░░██░░███░█░░░░█░░██░░████░████░░░█░░█░███░░█░░█░█░█░░░█░░███░░███░███░█░░░░█░█░░█░█░█░░░░██░░░█░░█░░██░█░░██░█░█░██░██░
█░░░█░█░█░░░█░░░░█░░░█░████░█░░░░█░░░█░█░░░█░░█░█░░██░█░░░█░░░░░░░█░░█░█░█░█░░██░░█░░░░█░░██░█░█░███░█░░█░░██░░░░██░█░█░█░█░░█░██░███░░░█░█░█░░░░░██░██░░░█░██░██░░░█░█░███░█░░░█░░░░░█░░█░░██░████░░░█░░██░░██░█░█░░█░██░░█░█░░██░█░█░░██░
█░██░░█░██░█░░████░███░░░█░░████░█░░█░░█░░█░█░░░█░█░░█░░█░█░█████░██░██░░█░█░█░░█░░███░█████░░░█░░░░██░█░░█░░░░█░░░░███░░█░░██░░██░░░░███░░█░███░░░█░░██████░░░█░███░░█░░░█░░░█░███░██░░░░░██░░█░░░████░░░█░░██░█░░███░░░███░█░█░░░█░░░█░░░
█░░░░█░░██░█░█░░░█░░░░████░░█░░░░░███░░░░█░░░███░░█░░░░█░░█░░░█░█░░░░░░░███░░█░░░█░░░░░░░░░░████░██░░█░░░█░░███░███░█░░█░██░██░░█░░█░█░███░░░░░░░█░░█░██░█░░░█░█░░░░░░░██░███░█░██░░█░░█████░░██░█░░░░░█░░░██░█░░█░░░░██░█░░░░░░░██░███░███
░░█░██░███░█░█░█░░███░░░░░█░░░█░██░░░███░█░░░░░░░░█░███░░████░█░░████░███░░░█░░░░█░█████░██░█░░█░█░█░███░█░█░░░░░█░░█░██░░█░░█░█░░██░░█░░░███████░██░░░░█░░█░█░░█░░░░░░░█░░░░█░░░░██░░███░░░░█░░░██░██░░█░░░░░░█░███░░█░░░██████░█░█░░░█░░░
░██░░█░░░█░░░░░░█░░█░░██░░███░█░█░░█░░█░░█░░░░░░░░█░░░█░█░░░█░░█░░░██░░░░░██░░░░░█░░█░░░░██░░███░█░█░█░█░█░█░░░░░█░█░░█░█░██░█░█░█░░█░█░█░░█░░░░░░░█░██░░░██░░█░████░░░░░███░░░██░█░██░░░░███░░████░█░█░░██░░░█░░░░░░░█░█░░█░░░█░██░░█░░░█░
░░██░░██░░█░███░██░░░███░░█░░█░░█░█░█░░░█░░░░░░░░░█████░█░█░░█░░██░░░██████░██░░░░█░░░█████░░░░█░█░█░██░░█░░█░░░░█░░░█░░█░░█░█░█░██░░░░░██░█░░░░░░░█░░░██░░░░░█░░░░░█░░░░░░░████░░██░░░████░░░█░░░░░░█░█░░░███░░█░███░░░░█░█░░░█░░░░█░█░██░
█░█░█░░░█░█░░██░██░██░░░█░█░██░░░░█░░███░░░░░░░░░█░░░░█░░░░█░██░░░██░░░░██░░░░██░░░█████░░░░██░░░█░█░░█░░██░░█░░█░░██░░██░██░█░█░░██████░█░░█░░░░░░░██░██░███░░████░█░░░░░░░░░░█░░░░░███░░░░███░██░█░██░░█░░░░███░░█████░█░░█░░█░██████░██░
█░░░███░░█░█░█░░█░░██░█░░░░░██████░░░░░░░░░░░░░░█░░██░█░██░█░░░░█░░░███░░░░██░░░█░░█░░░█░███░░██░░░██░██░░░█░░███░█░░░█░░░█░░█░░█░░█░░█░░░█░█░░░░░██░░█░░░█░░█░█░░░░░█░░░░░░░░████░░██░░░█████░░██░█░░░░░████░░░░█░█░░░░░██░█░░█░░█░░░░░█░░
░██░░░░█░░██░░░██░██░░██████░░░█░░░░░░░░░░░░░░░░█░█░█░█░░░░█░░██░██░░░█████░█░█░███░░█░█░█░░░░░░███░░░█░██░██░░░░░█░░░█░██░░█░█░██░░░░█░░░█░████░█░░██░░████░█░█░███░░█░░░░███░░░░█░█░░██░██░░░█░█░░████░░█░░░██░█░░░█░██░█░░████░█░████░░█
░░████░░█░░░████░░█░░█░░░░░░░█░█░░░░░░░░░░░░░░░░█░█░█░██░█████░░█░░░█░█░░░░░█░░░░░█░█░░█░░█░░░░░███░█░██░░░█░░███░░█░░█░░░░█░█░░░░███░█░░░█░░░░░██░░█░░██░░░░█░░█░░██░█░░░█░░░░██░█░░░██░█░░░█░█░░█░░░░██░█░██░█░█████░░░█░█░█░░░░█░░░░░░█░
░█░░░░█░███░░░░░░██░█░░███████░█░░░░░░░░░░░░░░░░█░░█░░█░░█░░░██░░░██░░█░░░░░░█░██░█░█░█░█░█░░░░█░░░░░░██░██░░█░░░█░█░░░███░█░█░██░░░█░█░░█░████░░█░██░██░░███░█░█░░█░░█░░█░░█████░░███░░░░░██░░█░░░███░░█░██░░░█░░░░░███░███░█░█░███████░░█
█░░██░░░█░░████░░█░░█░█░░░░░░░░░█░░░░░░░░░░░░░░░░█░████░░░░█░░██████░█░░░░░░░█░██░█░█░█░█░░█░░██░███░█░░█████░░███░█░██░░█░██░░░░██░█░█░█░░█████░░░█░░█░░█░░░██░░░░█░░░█░█░█░░░░░░█░░█░███░░█░░█░░░░░░█░█░░░░██░░███░░░░░░░░░█░░░░░░░░█░█░░
█░██░█░░█░░░░░░██░░█░░█░██░░█░█░█░░░░░░░░░░░░░░░░█░░░░░███░░█░░░█░░░░█░░░░░░█░░██░░█░░█░░█░░██░░░█░█░█░░░░░░█░█░░░░██░░░░░░█░░██░░█░█░░██░░░░░░░█░█░░█░░██░█░█░░███░██░░█░░██░███░█░░█░░██░████████░██░░███░█░█░██░█░░█░█░░██░█░█████░█░░█░
█░░░░█░█░███░░░█░░█░░██░░████░█░█░░░███░░░░░░░░░░░█░█░█░░░█░███░░░██░███████░░█░░█░█░█░░░░█░░░░█░█░█░░░█░██░░░█░██░░░░████░░██░░█░█░██░░█░█░███░░░█░█░░█░░░░░█░██░░░███░░░█░░░░░░░░████░██░░░░░░░░░█░░░██░░░░██░░░█░██░░██░█░█░░█░░██░██░░░
░█████░░█░░░█░█░░██░█░░█░░█░░░█░█░░█░░░██░░░░░░░░░██░░█░░░█░░░█████░░░░░░░░░░█░░█░░░░█░░░░███░█░░██░░██░░███░██░░█░█░█░░░░█░░░█████░░░█░█░░█░░░░█░█░░░░░░████░░░█░██░░░████░██░█░█░░░░█░░░█░░██░░█░░░█░░░░██░██░█░░░░█░██░░█░░░█░█░░█░░████
░░█░░░█░█░█░██░░█░░░█░░░█░█░██░░███░░█░░░███░░░░░█░░░█░░░░░███░░░░░░██░█░░█░██░██░███░░░░█░░░█░█░█░░█░█░█░░░░█░█░░░█░█░░░░░██░█░░░█░█░░░██░░░██░█░██████░░█░░░█░█░░░░█░░░░░░█░░█░░███░░██░░███░░██░██░░██░░█░░█░████░█░░█░░░████░░█░██░░░░░
███░█░░█░░█░█░░█░░█░████░░░░░░░░░░░░█░██░░░░█░░███░██░░░░░░░░█░█████░█░░███░░█░█░░█░░░░░█░░█░░░█░░░█░██░█░████████░█░█░░░░░█░░█░█░░█░███░░███░░█░░█░░░░░█░█░███░░█░██░███████░█░█░█░░█░░░█░░░█░█░█░░█░█░░█░░█░██░░░██░█░█░░░░░░██░█░░░██░░█
░░░█░█░░░██░░░██░██░░░░░░█░█░████░███░██░█░░█░█░░░░░░██░░░░░░█░░██░░░██░████░█░██░██░██░█░█░████░░███░░░█░░█░░░░░░░░░░██████░░░█░█░░█░░░██░░░░██░█░░░░░█░░█░░█░█░░█░░░█░░░██░░█░█░█░░░██░░██░█░░█░█░█░░█░██░░░█░░█░░░██░░█████░██░░░█░░░█░░
░█░█░█░██░█░██░█░░█░██████░█░░░██░░█░░██░██░░█░░░███░░░█░░░░░░█░░░░███░░█░░░█░░░░░░░█░░█░░██░░█░░██░░░██░█░░██░░█████░█░░░░░░█░░███░█░█░░░██░█░░░█░░░░█░░██░░█░░█░█░█░██░█░░░█░██░█░░░░░█░░░░░█░░█░░██░██░░██░█░██░█░██░█░█░░█░█░░█████░█░░
░█░░██░░░██░░█░░░░█░██░░░░░███░░░█░░░░██░░░█░█░█░░░███░░█░░░░░░███░█░░░██░█░░░█████░░░░█░█░░░██░███░███░░██░░░██░██░░█░░█░░██░█░░░█░█░░██░░░█░░█░░█░░░█░██░░█░░█░░███░░░█░░██░█░░░█░░░░░█████░░█░█░░░█░░░░█░░░██░░░█░█░░██░░█░░█░██░░░░░█░█
░██░░███░░░█░░█████░██░█░█░░░░██░████░█░█░░█░██████░░░█░█░░░░░░░█░░█░███░░██░██░░░████░█░█░███░░█░░░░░█░█░░██░█░█░░░█░░██░█░░█░██░█░██░░███░█░█░█░█░███░██░█████░█░░░██░█░░░█░░░██░░░░░█░░░█░█░█░████░█░░█░░███░░██░░█░█░█░██░██░░░█░█░██░░
░░░█░░█░██░██░░░███░██░░█░░██░█░░████░█░█░█░░█░░░░░░█░░░█░░░░░░░█░██░░░░░████░░░█░░░█░░█░█░░░░█░█░███░░░███░░░█░█░███░█░░░██░█░░█░█░█░██░░░░░█░░█░░█░░░█░░░█░░░░░░░█░██░███░█░░█░░░░██░█░█░░░░░░░█░█░░█░█░░█░░░░█░░█░█░░█░░░░░██░█░░██░░░█░
██░██░██░█░░░██░█░░░██░█░░█░█░░░█░░░░░███░░█░█░████░░████░░░░░░█░░░██░░██░░░█░░█░░█░░░██░█░█░░█░░█░░░██░█░░░█░█░█░░██░█░░█░░░██░█░█░█░░█░█░█░██░█░░█░█░░░█░█░█░░███░░░░░█░█░███░░███░░██░░█░█████░█░░██░█░█░░█░█░░░█░░█░░░█████░░██░░███░░░
░█░░█░░░█░░█░██░█░█░██░░░█░█████░░░███░░░░░█░█░█░░░█░█░░░█░░░███░█░░█░██░░█░░█░░░█░████░░░░█░█░█░█░█░░█░█░███░░█░█░██░░█░███░░█░█░█░█░░█░░██░░░██░██░█████░░░███░░█░██░░█░█░░████░░░░░███░█░░░░░░█░░█░█░█░█░██░░█░░░█░░░███░░░░░█░░█░█░░█░█
░░█░░██░░░█░█░░░░█░░█████░█░░░░███░░█░░█████░█░█░█░░░░░█░░███░░░░███░░█░░█░█░███░██░░█░░████░░█░░█░██░█░█░░█░█░█░█░█░█░░░░░░█░█░░░█░░██░█░░░░█░██░░█░░░░███░█░░░░█░░░██░█░░█░░░░░░███░░░░░████████░█░░█░█░░░███░░█░░█░██░█░░████░░█░░█░░█░░
░░░█░██░██░░█░██░█░█░░░░░██░░█░░░██░░░██░░░░░█░░░██░███░█░░░░░██░░█░░███████░░░░░░░██░░█░░░█░██░█░░██░░░░█░░█░░█░░░█░░█████░░░██░░░█░░░█░███░█░░██░░░░█░█░░░░█░░░█░██░░░█░░█░███░█░░░██░██░░░░██░░░███░░████░░░█░█░█░░░░░░██░░░█░█░█░░████░
░░░█░█░░█░░░█░░░░█░░░███░░░░░███░█░██░░░░████░░█████░█░░████░░██░░█░█░░░░░░█░░████░░░░█░░█░█░░░░██░░░███░██░░█░███░███░░█░░███░░░█░███░██░░░░██░█░███░█░░░██░░█░░█░██░██░░░█░░█░█░░█░█░░██░░█░░░░█░░░░░█░░█░░█░█░░█░░████░█░░█░█░████░█░░░░
░░█░░░██░░░░░█░█████░░░███░███░░░██░█░████░░█░██░░░░█░░█░░░░████░██░░░█░░█░░█░█░░░█░██░█░█░█░░█░████░░█░░░░█░█░░██░░░░░░█░░░█░░███░█░░░██░█░█░█░█░░█░░█░░██░█░░███░█░░█░░░█░░░██░░██░░████░░█░░█░███████░██░██░░█░░██░░░█░░█░░░█░░░░█░█░█░░
░█░░█░█░░░░░░█░░░░░░██░░█░░░░░░█░░░█░░█░░░██░░█░░██░░░█░░░░█░░░░░░░████░█░█░█░░██░█░█░░█░░░█░█░█░░░░█░█░██░█░██░░█░█░██░░█░█░░██░█░░░█░█░░█░░██░█░█░░█░░█░░█░██░░░█░░█░████░█░░█░█░░░░█░░░█████░░█░░░█░░░░█░█░█░██░░█░█░░░██░█░░█░█░░░█░███
█░░██░░███░░░░█░███░░██░░░██████░█░█░██░█░░█░█░░█░░███░░░░░█░█████░██░░░░░█░░██░░░░░░░███░░░░░░░░██░█░█░░░█░░░░█░░░█░░██░░█░░██░░████░░░█░██░░░░██░░█░░█░█░░█░█░█░░░███░░░█░██░░░█░███░░██░░░░░░█░░█░░░██░░░█░█░░░█░█░███░██░░█░░█░████░░██
░░██░█░░░░█░░░█░░███░░█░██░░░░░█░█░█░░░░██░░░█░██░█░░░░░░░░█░█░░░░█░░░█████░░█░░████░█░░░████████░█░░████░█░█░█░░████░░██░█░█░█░█░░░░░█░░░█░█████░░██░█░░░█░░░█░█████░░░█░░░█░███░░█░░░█░░░███░░█░█░░██░░██░░█░███░░█░█░█░█░█░██░░█░░░░░░░░
░█░░░░███░░█░███░░░██░█░█░████░░░█░░████░██░░█░░█░█░░░░░░░░█░█░██░█░██░░░░█░░░░█░░██░░░█░██░░░█░░░██░░░████░░░██░█░░░█░░░█░░█░█░░░████████░█░░░█░░█░█░░█░░█░███░█░░░█░░█░██░░█░░█░██░░██░██░░░░██░█░█░░█░░░█░█░██░░█░░█░█░░░█░░░█░░░██████░
█░░██░░█░█░░█░░███░██░█░░█░░░░░█░██░███░█░░██░█░░░░██░░░░░░█░░█░░░█░█░░██░█████░░█░░░░░░░██░█░█░█░██░█░░░░░░████░░░█░███░░█░░█░█████░░░░░██░░█░██░██░░░█░░█░░░█░░░█░██░█░░░█░░██░░███░██░░░░██░█░░█░░█░█░█░█░██░░░█░░█░██████░█░███░░██░░░░
░░█░░█░█░░█░░░░░░█░░░█░░░█░█░█░░░░█░░░░█░░██░░█░██░░░█░░░░░░█░██░██░░██░█░░░█░░██░░████░░██░██░░░░█░░░░█░░███░░░█░█░░░░██░█░░███░░░░████░░█░██░░█░██░██░░█░░█░████░░█░░█░██░█░██░░░░█░░░████░░░█░█░█░░█░░█░██░░░███░█░█░░░░░░░█░██░█░░█░███
░█░█░░░██░██████░█░█░███░░░█░░███░░███░█░██░░██░█░██░█░░░░░░█░░█░░░█░░░░███░█░░░░░█░░░░██░░░░█░█░█░░██░░██░░░░█░░░█░██░░░█░░█░░█░██░░█░░█░█░███░░░██░░░█░█░██░░░░░░█░░███░░░█░░░░██░░██░░░░░░███░░█░█░░░██░░█░███░█░██░░░█░██░░░░░███░█░░░░
░░██████░░█░░░░█░░░█░░░██████░░░███░░█░█░░░░█░█░░██░░█░░░░░█░░░███░███░░█░░░░███░██████░░░██░░██░█░█░░█░░█░███░░█████░██░█░██░░█░░░█░░██░░█░█░░█░██░░█░█░█░░█░██░███░██░░░███░░██░░█░█░███░██░░██░██████░██░█░░░░█░░█░░█░█░░░████░░░██░░░█░
█░░░█░░░░█░░░░█░░░█░░█░░░░░░███░░░░█░█░░██░█░░░█░█░░█░█████░░█░█░█░░░█░░█░██░█░█░░░░░░░░██░░█░░█░█░░░░░█░███░░█░██░░░█░█░█░░█░██░█░░█░░█░█░░█░█░░░░░█░░████░█░█░░█░░░░░░█░█░░░█░░░██░░░██░░█░█░░░░█░░░█░█░░░████░░███░█░██░█░█░░░██░░░░██░░
░██░█░█░█░░░░░█░█░░░░██████░░░██░█░░█░█░██░██░░█░░██░█░░░░░░██░░█░░█░░█░█░██░░█████░░████░░░░█░░░░████░░█░░░█░█░░█░█░░█░░░█░█░░░░██░██░░░█░██░█░█████░█░░░░░█░█░██░██░██░░█░███░█░██░█░█░░██░█░████░█░░█░░███░░░█░░░░██░░░░█░░░█░███░███░░█
░░█░░░█░░█░░░░█░░███░██░░░░██░░░░░█░██░░█░░░░████░░░░█░█████░░█░░░█░█░█░░░█░█░░░░░█░██░░░████████░░█░░██░░█░████░░░██░░███░░███░░██░█░█░██░░░░█░█░░░█░░██░███░█░░█░██░█░░██░██░░█░██░██░░█░░░█░░░█░░██░░░░░░░█░░░███░░░█░██░█████░░░░█░░░██
██░░██░█░░█░░░░█░█░░░█░░██░░░░░██░░░░░░█░░██░░░░█░░██░░█░░░░█░█████░█░█░██░██████░░░██░█░░░░░░█░░█░█░░░█░██░█░░░░█████░███░█░░███░░░█░█░█░░███░█░░█░░█░██░░██░░█░░░░░░█░█░░░██░██░█░░█░░█░░███░█░█░█░░██████░█░░█░░░██░░░░░███░░░░████░██░░
░░░░█░░░█░█░░░░█░█░███░█░█████░░██░█░██░░█░██░█░█░██░█░░░██░░░██░░░░█░█░░░░░░░░░█████░░█░█░██░░██░░█████░██░█░░██░░░░█░░░░░██░░░█░████░░█░█░░░█░░█░█░█░██░░░░█░░███░██░░█░██░█░░█░░░█░░██░░██░░██░░█░████░░░░█░░█░█░░█████░█░░░█░█░░░█░░░░░
░██░█░░░█░░█░░█░░█░░░█░░░░░░░░░░█░░█░░████░░░░█░░░█░░█░██░░███░░░██░░░█░░███░███░░░█░░█░░█░░██░░░█░░░░░░░░█░░░░░█░██░░██░████░█░░█░░░█░█░░░░█░█░██░░░█░░█░██░██░█░░░█░███░░░██░░███░█░░██░█░░░█░█░███░░░░░██░█░█░░░█░░░██░░█░███░░███░░████
█░░░█░░░█░░░██░░█░██░█░█░░█████░░░░░░░█░░░████░█░██░█░░░███░░█░█░░░███░░█░█░░█░█░█░░█████░█░░░██░░███████░░████░█░░░█░░░█░░░░█░█░░░█░░░█░██████░░█░█░░█░░█░░░█░░█░█░██░░░██░█░░░█░█░░█░░█░░░██░░█░░░░░█░██░░░█░█░███░█░█░░█░░████░░░░░█░░░░
█░█░█░███░█░██░█░░░█░░░█░██░░░███████░█░█░█░░██░░█░░░░█░░░░░██░████░░░███░█░█░░█░░██░░░░███░█░░██░█░██░░░█░█░░█░░██░███░░░██░█░░█░░░███░░█░█░░░█░█░░█░░█░░█████░█░█░░░░█░█░░█░█░█░░██░░█░█████░█░░████░░█░░█░░█░░█░░░███░██░██░░░░█████░██░
░░█░██░░░██░█░░█░░░░████░░░░█░░░░█░░█░░░█░░█░██░░░░███░███░░██░█░█░░█░░█░░█░░█░█░█░░░░█░░░░█░█░██░░░░█░█░░░█░█░░█░░░█░████░█░░█░█░██░░░█░██░░█░░░██░░█░███░░░░░░█░░█████░░█░░██░░█░██░██░░░░░░█░░░░░██░██░░██░░█░░░█░█░░░██░░█░███░░░░░██░░
░███░░░█░░█░█░█░░░░█░░░░████░█░█░░█░░██░██░░░░░░███░░░░░░░██░░░██░░███░█░█░█░█░█░░░██░░███░██░░█░░██░░░█████░░░██░█░█░░░█░░░█░█░░░░░░█░█░█░░█░█░░███░░█░░░░██░█░░█░░█░░░█░█░░░░█░█░██░░█░████░█░███░░░░█░█░█░█░█░███░█░███░░░░█░░█░███░██░█
░░░░░██░█░█░█░█░░███░███░░░█░█░██░░██░░░░████░░░█░░░░░░░░░░█░█░██░█░░░░█░█░█░░█░███░░█░░█░░░░░█░░█░░██░██░░█░██░█░░█░░█░░███░░░█░█░██░░░░█░█░░█░█░░░█░█░█░█░░░█████░█░█░░░█░██░░░█░█░█░░░█░░█░█░░░░█████░█░█░░█░░█░░░█░█░░░██░████░░██░██░░
█░█░░████░█░░░█░█░░░░█░░░█░█░█░░░█░░█░██░░░░███░░█░░░░░░░░░█░░░░█░█░████░░███░█░█░░░░░█░█░████░░████░█░░░░░░░░██░░██░█░█░░░░██░█░░░█░░███░░█░░█░█░█░█░█░░░████░█░░░░██░█░██░█░██░█░█░░█░░█░██░██████░░░░██░░██░░█░░█░█░█░██░█░░░░██░░█░░░░░
░░█░█░░░░██░█░░█░░███░░██░░███░█░░█░█░█░█░█░░░██░█░░░░░██████░██░░███░░░█░░░░░█░░█░░░░█░░░█░░░░█░░░░█░░██████░░█░██░░█░░███░░░░████░░█░█░░█░██░░█░░░░░██░█░░░░██░█░░░░██░░█░░██░░░░█░░░█░█░░█░░██░░░░██░░░█░░░░██░██░█░█░░█░████░█░█░░█████
░█░░░░██░░░░██░░░██░░░█░░█░░░░████░░█░░█░░███░██░░█░░░█░░░░░░░██░█░░░░█░██░█████░█░░░░█░███░░█░░░░█░█░█░░█░░░█░░░██░█░░░░░░█░██░░██████░░█░█░░░███░█████░░░░█░░█░░███░░██░░█░░█░██░░█░░█░██░░█░█░░███████░░█░██░█░░█░░░██░█░░░░█░░███░█░░█░
░░█░░█░░██░░███████░█░░█░████░░░░░░█░█░█░█░██░█░█░████░░█░░█░█░█░░█░███░██░░░█░░░█░░░░█░░░██░█████░░░░░░█░░█░░██░██░█░░░░░░█░░███░░░░░░█████░█░█░░░█░░░████░██░░██░░░█░██░███░█░███░░██░░█░█░█░█░███░░░░█░█░░█░░░█░░█░░██░░█░█░░█░█░░░░░░█░
█░░░█░░░░░█░░░░░░░░░██░░░█░░░███░██░░█░░░█░░░░█░█░░░░░░█░░█░░█░░█░░░█░█░░░░█░░░██░░░░░░██░░░░█░░░░░████░░░█░█░░█░░░░█░░░░░░░█░░░░░█░░█░░░░░░░█░░░█░░░█░░░░░░█░█░░░░█░░░██░░░░░█░░░░█░░░░█░░█░░░█░░░░░█░░█░░░█░░░░░█░░██░░█░░░██░█░░░████░░░